11111111111111111111111111
100000000C0C0C000C0C0C0C01
100000000101C1011000000111
1000000C010P0000000C000E01
11111111111111111111111111